R 1300 700
NO ../texture/metal.xpm
SO ../texture/brick.xpm
WE ../texture/grass.xpm
EA ../texture/stone.xpm

S ../texture/barrel.xpm
F 220,100,0
C 225,30,0

     1111111111                11111111111111111111111111111111111111
     1111011111                10111111111101111111111111111111
     1000000001                10000000000000000000000000000001
     1000000001                10000000000000000000000000000000000001
     1000000001111111111111111110000000000001000001000000000000000001
     1000000000000000000000000000000000000001000001000000000000000001
     1000000001111111111111111110000000000001000001000000000000000001
     1000000001 10000000000000000000000000000000000000000000000000001
     1000000001  1000000000000000000000000000000001000000000000000001
     1111111111   100000000000000000000000000001111111011111111111111
                  111111111111110000000000000001     101
                               10000000000000001     101
                               10000000000000001     101
                               10000000000000001     101
                               100000N00000000011111110111111
                               100000000000000010000000000001
                               100000000000000010000000000001
                               100000000000000010000000000001
                               100000000000000010000000000001
                               100000000000000010000000000001
                               111111111111111111111111111111
